1111111111111
10010000000C1
1000011100001
1P0011E100001
1111111111111
