11111111
1P0E00C1
11110111
1X110111
10000111
11111111
