111111111111111111111
1P0000C00E0C000000001
111111111111111111111
