111111
1P00E1
111111
1CCC11
111111