1111111111111
10010000001C1
1000011000011
1P0011E000001
1111111111111
