1111111111111
10010000000C1
1100011111001
1P1001E000001
1111111111111
