1111111
1P000C1
11111C1
1E001C1
1111111
