1111111
1P000E1
1111101
1E001C1
1111111