1111111
1P000C1
1111101
1E000C1
1111111
