11111
100C1
1E001
1P001
11111
